+-+-+-+-+-+-+-+-+-+-+
|   |     |         |
+ + + +-+ + +-+ +-+ +
| |   |       | |   |
+-+ +-+ +-+ + + + + +
|   |   |   |   |   |
+ + +-+ + +-+ +-+ + +
| |     |         | |
+-+-+-+-+-+-+ +-+-+-+
|           | |     |
+-----------+-+-----+
