+-+-+-+-+
|   |   |
+ + + + +
|       |
+ + + + +
|   |   |
+ +-+ + +
|       |
+ +-+-+-+
| |     |
+-+-----+